//FIRST MUST BE ENGLISH SECOND MUST BE UKRAINIAN WORD
the authorities=адміністрація;
capvitivity=неволя||полон;
interference=втручання;
to be in deep water=бути в складній ситуації;
to be down to earth=бути приземленим;
to go down a storm=мати успіх;
devastating=руйнівний;
sensible=розумний;
convincing=переконливий;
oncoming=зустрічний;
get hold of=знайти й купити||дістати;
newsagent's=газетний кіоск;
force out=виштовхувати;
delight=задоволення;
figure=число;
loveable=привабливий||любий;
to subscribe=передплачувати;
tabloid newspapers=жовта преса;
suspense=напруга||невирішеність;
promising=перспективний;
to convince=переконувати;
to bring round=переконати;
to tune in=налаштовуватись;
to tune out=відключити;
annualy=щорічно;
succession=наступність||послідовність;
aware=поінформований;
fee=плата||гонорар;
medium=засіб;
sophisticated=витончений;
beyound=за межами;
to be fond of=захоплюватись;
be obsessed=бути одержимим;
to arrest=привертати увагу;
assignment=завдання;
particularly=особливо;
to be drawn to=захопитись;
passion=пристрасть;
application=заява;
reference=характеристика||рекомендація;
indefinitely=неясно;
redundant=зайвий||непотрібний;
to come by=знайти;
to hit it off=ладнати;
wages=погодинна заробітня плата;
salary=щомісячна заробітня плата;
previous=попередній;
sales department=відділ продажу;
an applicant=претендент на посаду;
to lay off=звільнити||припинити роботу;
to get the sack=вигнати;
desparately=відчайдушно;
on behalf=від імені;
to exaggerate=перебільшувати;
reduction=зменшення;
supervision=контроль||нагляд;
observation=спостереження;
accountant=бухгалтер;
occupation=зайнятість;
majority=більшість;
to occur=ставатись||траплятись;
significant=значний||знаменний;
overhead compartment=відділення для ручного багажу в літаку;
to buckle up=пристебнутись;
to be herded=бути загнатим;
to establish=встановити;
to spread=розповсюджуватись;
deservedly=заслуженно;
hustle and bustle=суєта;
to emerge=з'являтись;
to contemplate=споглядати;
port of call=перевалочний пункт;
to submerge=зануритись;
to retain=зберігати||залишати;
justifiably=справедливо;
to equal=вести до;
en route=в дорозі||по дорозі;
follow in smb's footsteps=йти по стопам;
causeway=бруківка;
worthwhile=бути вартим;
to get off=зійти з;
interlocking=з'єднаний;
origin=походження;
cruise=круїз;
cuisine=національна кухня;
currence=валюта;
itinerary=путівник;
sightseeing=огляд визначних пам'яток;
luggage=багаж;
boarding pass=посадковий талон;
flight attendant=стюардеса;
to check in=пройти реєстрацію;
a passport=паспорт;
driving license=водійське посвідчення;
a package holiday=тур все включено;
to afford=дозволити собі;
storage chamber=камера зберігання;
glacier=льодовик;
melt=плавитись||розтавати;
deck=палуба;
cabin=будиночок||каюта;
trekking=піший похід;
concern=запепокоєння;
excitement=хвилювання;
trek=подорож;
refreshments=частування;
accommodation=житло;
crap=лайно;
relief=полегшення;
clause=пункт;
tenses=часи;
faint=знепритомніти;
provided=якби;
as long as=поки;
campsite=кемпінг;
custom=звичай;
go though customs=пройти митницю;
departure=відліт;
apparently=очевидно;
paragliding=пара планеризм;
fun packed=веселий;
bumpy=нерівний||вибоїстий;
idylic=ідилічний;
breathtaking=захоплюючий;
to let smb down=розчарувати;
a complete let down=повне розчарування;
overprised=дорогущий;
to get away=втекти;
to drop off=завести;
to set out=відправитись;
to get on=попасти||сісти на;
to put up=встановити||поставити будівлю;
ti get around=пересуватись;
to see off=проводжати;
bystander=спостерігач;
onlooker=глядач;
passers by=перехожий;
contemporary=сучасний;
stall=прилавок;
pedestrian only=лише для пішохідів;
on the spot=відразу||негайно;
dynamic=динамічний;
moving=зворушливий;
astonishing=вражаючий;
impromptu=експромт;
dais=платформа||підвищення;
judge=суддя;
convict=засуджений;
arsonist=підпалювач;
memoribilia=пам'ятні речі;
notorious=горезвісний;
court house=будівля суду;
to flicker=мерехтіти;
spare=вільний;
facility=можливість;
innocent=невинний;
guilty=винний;
prosecution=обвинувачення;
alibi=алібі;
handcuffs=кайданки;
sentence=покарання;
verdict=вирок||вердикт;
to try=судити;
pickpocket=кишеньковий злодій;
to suffer the consequences=страждати від наслідків;
fine=штрав;
to serve a sentence=відбувати покарання;
shoplifting=крадіжка з магазину;
community service=громадські роботи;
suspect=підозрюваний;
slip out of smth=вислизнути;
to prosecute=обвинувачувати;
to accuse=звинуватити;
fair=справедливий;
unfair=несправедливий;
CV=резюме;
attitude problem=проблема з поведінкою;
turn a crime=скоїти злочин;
commit=вчинити;
encourage=заохочувати;
youth=молодь;
attitude=ставлення;
neighborhood=район;
amusing=кумедний;
poverty=бідність;
offender=кривдний;
to prevent=запобігти;
to find guilty=визнати винним;
to plead guilty=визнати вину;
against the law=проти закону;
seize=захопити||вилучити;
custody=опіка;
warrant=ордер;
authority=повноваження||влада||авторитет;
to mend one's ways=виправитись;
to break the law=порушити закон;
obey=підкорятися;
contrary=навпаки;
to solve a case=розкрити правду;
accountability=відповідальність||звітність;
a police record=поліцейське досьє;
to let off with warning=відпустити з попередженням;
punishment=покарання;
jury=присяжні;
law court=суд;
trial=судовий процес||процес||випробування;
shuffle=перетасувати;
interrogative=питальний;
divorce=розлучення;
fortress=фортеця;
to utilize=використовувати;
concealment=приховування;
favor=послуга;
odds=шанси;
outgunned=без зброї;
outnumbered=переважають чисельно;
handle=впоратися;
chasing=переслідування;
quote=цитата;
ideally=в ідеалі;
faith=віра;
heart racing=серце калатає;
patience=терпіння;
dealt=уклав угоду;
actually=взагалі то||насправді;
ahead=попереду;
gotta=мушу;
thoug=хоча;
whipped=побитий;
doubt=сумнів;
through=за допомогою;
whiff=понюхати;
rather=скоріше;
zeroed=нулевий;
suppose=припусимо;
earlier=раніше;
cheeky=нахабний;
quiet=тихо;
straight=прямо;
vaguely=невиразно;
overlook=не помічати;
still=досі;
still on the loose=все ще на волі;
disengage=від'єднатися;
downstairs=внизу;
freaked=злякався;
peek=поглянув;
pinewood=сосна;
necessary=необхідний;
unnecessary=непотрібний;
goodness=доброта;
unless=якщо тільки;
across=через||по всьому;
spot=точка||місце||пляма;
ink=чорнило;
concrete=бетон;
chase=погоня;
spotted=помітив;
shifted=змістився;
dice=кубики;
frustration=розчарування;
whether=чи;
desperate=у відчаї;
methodical=методичний;
immersive=занурення;
overhead=накладні витрати;
overhaul=капітальний;
pending=на розгляді;
competitive=конкуретний;
vital=життєво важливий;
to tell a lie=збрехати;
so far=поки що;
fundraising=збір коштів;
compatible=сумісний;
present=теперешій;
inefficiencies=неефективність;
introduce||represent=представляти;
retire=піти на пенсію;
sufficient=достатньо;
efficiently=ефективно;
explicitly=явно||чітко||недвозначно;
suggest=припустити||пропонувати;
ownership=право власності;
consider=розглянути||вважати;
inequality=нерівність;
concise=лаконічний;
obtain=отримати;
serve=служити||подати;
independently=самостійно;
invoke=викликати;
perform=виконувати;
typically=зазвичай;
poacher=браконьєр;
poaching=браконьєрство;
grind=розтирати;
illegaly=незаконно;
powder=порошок;
gibbon=гібон;
serial||series=серіал;
astronaut=астронавт;
astronomer=астроном;
derive=виводити||отримувати;
valley=долина;
spoil=зіпсувати;
laid out=викладений;
to serve food=подавати їжу;
hostess=господиня;
stoppage=зупинка;
confused=розгублена;
manuscript=манускрипт;
grueling=виснажливий;
hospitable=гостинний;
stretcher bearers=носилки;
essence=суть;
voluntary=добровільно;
makeshift=імпровізований;
certain=певний;
proper=власне;
revalue=переоцінювати;
gauze=марля;
blanket=ковдра;
conduct=поведінка;
assessment=оцінка;
occasionally=іноді;
mention=згадка;
appropriate=відповідний;
prospective=перспективний;
decomposition=розкладання;
presence=наявність;
durable=довговічний;
to sweat=потіти;
deaf=глухий;
joint=спільний||суглоб;
carnality=карнавал;
coax=вмовляти;
golly=чорт забирай;
clause=пункт;
participle=дієприкметник;
struggle=бородьба;
share=акція;
enormous=величезна;
adverb=прислівник;
haunted=з привидами;
to tackle crime=боротися зі злочнністю;
burglar=грабіжник||злодій;
troublemaker=порушник спокою;
excuse=привід||вибачення;
vintage clothing=вінтажний одяг;
lycra=лайкра;
perm=завивка;
spiky=колючий;
shell suite=спортивний костюм;
laughable=схімовинний;
ridiculous=смішний;
tight=тісний;
mainstream=основний напрямок;
legwarmer=гетри;
eyeliner=підводка для очей;
leggins=легінси;
embarrassing=ганебний;
puff skirt=багатошарова спідниця;
heels=підбори;
to recreate=відтворити;
shoulder pad=наплічник;